

SO ./textures/t2.xpm
EA ./textures/t4.xpm
NO ./textures/t1.xpm
WE ./textures/t3.xpm


F 2,255,100
C 255,225,255


111111111111
10S000000001
100000000001
1000000001011111111111
100001000001   1000001
100100000001    100001
100000000001     11111
100000000001     11111
100000000001000011111
11111111111111111
1001
111
