

SO ./textures/t2.xpm
EA ./textures/t4.xpm
NO ./textures/t1.xpm
WE ./textures/t3.xpm


F 2,255,100
C 255,225,255


1      11111111111111111
111111110000000000000011
11111111111111111111111
10100000001         101
100000000001    111111
1000000001011111111111
100001110001   1000001
100100000001   100001
100000000000111111111
1111111111101
          11111111111111111111111111111
11111111111011111111111111111110111111
100000000000000111111111111111111111111111
1111111111111111111111
1N11111111111
111
