

SO ./textures/bayrak.xpm
EA ./textures/harita.xpm
NO ./textures/kusatma.xpm
WE ./textures/metehan.xpm


F 2,255,100
C 0,225,255


11111111
10000111
11N00011
10000001
11111111